           _         _                 
 ___  ___ | | _____ | |__   __ _ _ __  
/ __|/ _ \| |/ / _ \| '_ \ / _` | '_ \ 
\__ \ (_) |   < (_) | |_) | (_| | | | |
|___/\___/|_|\_\___/|_.__/ \__,_|_| |_|
                                       
