10 10
1111111111
1111111111
1111111111
1111111111
1111151111
1111111111
1111111111
1111111111
1111111111
1111111111
12221
12521
12221
11111
